NO textures/wood.xpm
SO textures/wood.xpm
EA textures/wood.xpm
WE textures/wood.xpm

F 0,0,0
C 0,0,0

11111
10001
10A01
10001
11111