NO		textures/wood.xpm
SO		textures/wood.xpm
EA	 textures/wood.xpm
WE 	textures/wood.xpm

F 100,23,200
C		0,50,50

111111111
100000001
10010011
100110001
101N1101
10010001
100010001
100000001
111111111