NO ./textures/nostromo_1.xpm
SO ./textures/gang.xpm
EA ./textures/magrathea_1.xpm
WE ./textures/nautilus_1.xpm

F 125,125,125
C 135,206,235

111111111111111111111111111
100000000100000010000000001
100000000100000010000000001
100000000100000010000000001
100000000000000000000000001
100000000000000000000000001
100000000000000000000000001
1000000000000N0000000000001
100000000000000000000000001
100000000000000000000000001
100000000000000000000000001
100000000000000000000000001
100000000000000000000000001
111111111111111111111111111